G G G G G G G G
G G G G G G G G
C C C C C G G G
C C C C C G G G
G G G G G G G G
G G G G G C C C
G G G G G C C C
G G G G G G G G
