G G G G G G G G
G G G G G G G G
D D D D G G G G
G G G D D D D D
G G G D D D D D
G G G D D D G G
G G G D D D G G
G G G D D D G G
