G G G G G G G G
G D D D D D D G
G D G G G G D G
G D G G G G D G
G D G G G G D G
G D G G G G D G
G D D D D D D G
G G G G G G G G
