G G G D G G G D
G D G G G D G D
G G G D G D G G
G D G G G G G G
G G G D G D G G
G D G G G D G G
G G G D G G G D
G D G G G G G D
