G G G G C C G G
G C G G C C G G
G G G G C C C G
G C C G C C G G
G G G G C C G G
G C C G C C C G
G C C G C C G G
G G G G C C G G
